16 23 1
./matter/grass.png
./matter/teleport.jpeg
./matter/dark.png
0 0 0 0 0 82 79 86 86 89 0 0 0 0 0 0
0 101 0 0 0 0 0 0 0 0 0 0 0 0 0 0
0 0 0 0 3 0 0 0 0 0 0 0 0 0 0 0
3 0 0 0 0 0 0 0 0 0 0 0 0 0 0 0
0 0 0 0 0 0 0 0 0 0 0 0 25 0 0 0
0 0 0 0 0 0 0 0 0 0 0 0 0 0 0 0
27 0 0 0 0 0 0 0 25 0 0 0 0 0 0 1
2 0 0 0 0 0 0 0 0 0 0 0 0 0 0 0
27 0 0 0 0 0 0 0 0 0 0 0 0 0 0 0
0 0 0 0 0 0 0 0 0 0 0 0 0 0 0 0
0 0 0 0 0 0 0 0 0 0 0 0 0 0 0 0
0 0 0 0 0 99 99 0 0 0 0 0 0 0 0 0
0 0 0 0 0 99 26 0 0 0 0 0 0 0 0 0
99 99 0 0 0 0 0 0 0 0 0 0 0 0 0 0
0 0 0 99 0 0 0 0 0 0 0 0 0 0 0 0
99 99 99 99 99 0 0 0 0 0 0 0 0 0 0 0
0 0 0 99 99 0 0 0 0 0 0 0 0 0 0 0
0 0 0 99 99 0 0 0 0 0 0 0 0 0 0 0
0 0 0 24 0 0 0 0 0 0 0 0 0 0 0 0
99 0 0 22 0 0 0 0 0 0 0 0 0 0 0 0
0 0 0 22 0 0 0 0 0 0 0 0 0 0 0 0
0 0 0 22 0 0 0 0 22 0 0 0 0 0 42 0
0 0 0 0 0 0 0 0 0 0 0 0 0 0 0 0
