5 5 5
1 0 0 0 0
0 0 0 0 1
0 0 0 0 0
0 0 0 0 0
5 5 5 5 5
